45x25
            #####   #####   #####
            #####   #####   #####
 @##########################################  
 #            #       #       #            #  
 #            #       #       #            #  
 #            #       #       #            #
#######    ####### ####### #######    #######
################## ####### #######    #######
#######    ####### ####### #######    #######
#######    ####### ####### #######    #######
#######    ####### ####### #######    #######
#######    ####### ####### #######    #######
#######    ####### ####### #######    #######
#######    ####### ####### #######    #######
#######    ####### ####### #######    #######
#######    ####### ####### #######    #######
#######    ####### ####### #######    #######
#######    ####### ####### ##################
#######    ####### ####### #######    #######
 #            #       #       #            #  
 #            #       #       #            #  
 #            #       #       #            #  
 ##########################################@  
            #####   #####   #####
            #####   #####   #####